0 w ▢ ▢ ▢ ▢ ▢ ▢ ▢ ▢ 
▢ ▢ ▢ ▢ ▢ ▢ ▢ ▢ ▢ ▢ 
▢ w ▢ ▢ w w w w ▢ ▢ 
▢ ▢ ▢ ▢ w ▢ ▢ ▢ ▢ ▢ 
▢ ▢ ▢ ▢ ▢ ▢ ▢ ▢ ▢ ▢ 
▢ ▢ x ▢ w ▢ ▢ w ▢ ▢ 
▢ ▢ ▢ ▢ w ▢ ▢ ▢ ▢ ▢ 
▢ ▢ ▢ ▢ w ▢ ▢ w ▢ ▢ 
▢ ▢ ▢ ▢ w ▢ ▢ ▢ ▢ ▢ 
▢ ▢ ▢ ▢ ▢ ▢ w ▢ ▢ 0 
