Y . . . . . . . . . 
. w w . . . . w w . 
. w . . . . . . w . 
. . . . w w . . . . 
. . . . w w . . . . 
. . w w w w w w . . 
. . . . w w . . . . 
. w . . . . . . w . 
. w w . . . . w w . 
T . . . . . . . . K 