Y 0 0 0 0 0 0 0 0 0 
0 0 0 0 0 0 0 0 0 0 
0 0 0 0 0 0 0 0 0 0 
0 0 0 0 w 0 0 0 0 0 
0 0 0 0 w 0 0 0 0 0 
0 0 0 0 w 0 0 0 0 0 
0 0 0 0 w 0 0 0 0 0 
0 0 0 0 w 0 0 0 0 0 
0 0 0 0 0 0 0 0 0 0 
T 0 0 0 0 0 0 0 0 K 
